NO ./textures/wall_n.xpm
SO ./textures/wall_s.xpm
WE ./textures/wall_w.xpm
EA ./textures/wall_e.xpm
F 220,100,0
C 225,30,0

     
111111111111111111111111
100000000011000000000001
101100000111000000000001
100100000000000000000001
101100000111000000000001
100000000011000001110111
111101111111111111000001
111101111010101011010101
110000001101010111000001
100000000000000011000001
100000000000000011010101
110000001101010111110111
111101111111011111110111
111101111111001011000001
110000011100000011000001
100000001100000011000001
100000001111111011100011
100000001111111110010101
110000011100011010100011
100000001000001101010101
100000000000000000000001
100000001000001101010101
110000011100011010100011
111111111111111111111111